NO ./textures/Wall_1.png
SO ./textures/Wall_2.png
WE ./textures/Wall_3.png
EA ./textures/Wall_4.png

F 13,30,13
C 0,0,0

        1111111111111111111111111
        1000000000110000000000001
        1011000001110000100000001
        1001000000D00000000000001
111111111011000001110000000000001
10000000001100000111D111111111111
1111D111111111D11100000010001
11110111111111011101010010001
110000001101010111000000D0001
10000000000000001100000010001
10000000000000001101010010001
11000001110101011111011110N0111
11110111 1110101 101111010001
11111111 1111111 111111111111