NO ./textures/Wall_1.png
EA ./textures/Wall_4_btorch.png
SO ./textures/Wall_2.png
WE ./textures/Wall_3_rtorch.png

F 13,30,13
C 0,0,0

        1111111111111111111111111
        1000000000110000000000001
        1011000001110000100000001
        1001000000D00000000000001
111111111011000001110100000000001
10000000001100000111D111111111111
1111D111111111D11100000010001
11110111111111011101010010001
1000000000000000D0000000D0001
10000000000000001110000010001
10000000000000001101010010001
10000000000000001110000010001
10000000000000001110000010001
10000000000000001110000010001
10000000000000001110000010001
10000000000000001110000010001
10000000000000001110000010001
11000001110101011111011110E0111
11110111 1110101 101111010001
11111111 1111111 111111111111