NO ./textures/Asset_1.png
SO ./textures/Asset_1.png
WE ./textures/Asset_1.png
EA ./textures/Asset_1.png

F 50,110,40
C 135,206,235

111111111111
10N100000001
100000000001
111110111011
111111111011
111111111011
100000000011
101111111111
101111111111
100000000001
100000000001
111111111111