NO ./textures/Asset_1.png
SO ./textures/Asset_1.png
WE ./textures/Asset_1.png
EA ./textures/Asset_1.png

F             220,100,0
C            1,30,0                             

        1111111111111111111111111
        1000000000110000000000001
        1011000001110000000000001
        1001000000000000000000001
111111111011000001110000000000001
100000000011000001110111111111111
11110111111111011100000010001
1111011111111101110101000001
11000000110101011100000010001
10000000000000001100000010001
10000000000000001101010010001
110000011101010111110111100111
11110111 1110101 10111101N001
11111111 1111111 111111101111